BBBBBBBBBBBBBBBBBBBBBBBBBBBBBBBBBBBBBBBBBBBBBBBBBBBBBBBBBBBBBBBBBBBBBBBBBBBBBBBBBBBBBBBBBBBBBBBBBBBBBBBBBBBBBBBBBBBBBBBBBBBBBBBBBBBBBBBBBBBBBBBBBBBBBBBBBBBBBBBBBBBBBBBBBBBBBBBBBBBBBBBBBBBBBBBBBBBBBBBB
BBBBBBBBBBBBBBBBBBBBBBBBBBBBBBBBBBBBBBBBBBBBBBBBBBBBBBBBBBBBBBBBBBBBBBBBBBBBBBBBBBBBBBBBBBBBBBBBBBBBBBBBBBBBBBBBBBBBBBBBBBBBBBBBBBBBBBBBBBBBBBBBBBBBBBBBBBBBBBBBBBBBBBBBBBBBBBBBBBBBBBBBBBBBBBBBBBBBBBBB
BBBBBBBBBBBBBBBBBBBBBBBBBBBBBBBBBBBBBBBBBBBBBBBBBBBBBBBBBBBBBBBBBBBBBBBBBBBBBBBBBBBBBBBBBBBBBBBBBBBBBBBBBBBBBBBBBBBBBBBBBBBBBBBBBBBBBBBBBBBBBBBBBBBBBBBBBBBBBBBBBBBBBBBBBBBBBBBBBBBBBBBBBBBBBBBBBBBBBBBB
BBBBBBBBBBBBBBBBBBBBBBBBBBBBBBBBBBBBBBBBBBBBBBBBBBBBBBBBBBBBBBBBBBBBBBBBBBBBBBBBBBBBBBBBBBBBBBBBBBBBBBBBBBBBBBBBBBBBBBBBBBBBBBBBBBBBBBBBBBBBBBBBBBBBBBBBBBBBBBBBBBBBBBBBBBBBBBBBBBBBBBBBBBBBBBBBBBBBBBBB
BBBBTTTT....................WWWWWWWWWWWWWWWWWWWWWWWWWWWWWWWWWWWWWWWWWWWWWWWWWWWWWWWWWWWWWWWWWWWWWWWWWWWWWWWWWWWWWWWWWWWWWWWWWWWWWWWWWWWWWWWWWWWWWWWWWWWW........WWWWWWWWWWWWQQQQQQQQQQQQ............BBBB
BBBBTTTT....................WWWWWWWWWWWWWWWWWWWWWWWWWWWWWWWWWWWWWWWWWWWWWWWWWWWWWWWWWWWWWWWWWWWWWWWWWWWWWWWWWWWWWWWWWWWWWWWWWWWWWWWWWWWWWWWWWWWWWWWWWWWW........WWWWWWWWWWWWQQQQQQQQQQQQ............BBBB
BBBBTTTT....................WWWWWWWWWWWWWWWWWWWWWWWWWWWWWWWWWWWWWWWWWWWWWWWWWWWWWWWWWWWWWWWWWWWWWWWWWWWWWWWWWWWWWWWWWWWWWWWWWWWWWWWWWWWWWWWWWWWWWWWWWWWW........WWWWWWWWWWWWQQQQQQQQQQQQ............BBBB
BBBBTTTT....................WWWWWWWWWWWWWWWWWWWWWWWWWWWWWWWWWWWWWWWWWWWWWWWWWWWWWWWWWWWWWWWWWWWWWWWWWWWWWWWWWWWWWWWWWWWWWWWWWWWWWWWWWWWWWWWWWWWWWWWWWWWW........WWWWWWWWWWWWQQQQQQQQQQQQ............BBBB
BBBB........................WWWWWWWWWWWWWWWW........WWWWWWWWWWWWWWWWWWWWWWWWWWWWWWWWWWWWWWWWWWWWWWWWWWWWWWWWWWWWWWWWWWWWWWWWWWWWWWWWWWWWWWWWWWWWWWWW................CCCC........QQQQQQQQ............BBBB
BBBB........................WWWWWWWWWWWWWWWW........WWWWWWWWWWWWWWWWWWWWWWWWWWWWWWWWWWWWWWWWWWWWWWWWWWWWWWWWWWWWWWWWWWWWWWWWWWWWWWWWWWWWWWWWWWWWWWWW................CCCC........QQQQQQQQ............BBBB
BBBB........................WWWWWWWWWWWWWWWW........WWWWWWWWWWWWWWWWWWWWWWWWWWWWWWWWWWWWWWWWWWWWWWWWWWWWWWWWWWWWWWWWWWWWWWWWWWWWWWWWWWWWWWWWWWWWWWWW................CCCC........QQQQQQQQ............BBBB
BBBB........................WWWWWWWWWWWWWWWW........WWWWWWWWWWWWWWWWWWWWWWWWWWWWWWWWWWWWWWWWWWWWWWWWWWWWWWWWWWWWWWWWWWWWWWWWWWWWWWWWWWWWWWWWWWWWWWWW................CCCC........QQQQQQQQ............BBBB
BBBB........................WWWWQQQQWWWWWWWWWWWWWWWWWWWWWWWWWWWWWWWWWWWW....................................................WWWWWWWWWWWWWWWWWWWWWWWWWWWW............EEEE........WWWWQQQQ............BBBB
BBBB........................WWWWQQQQWWWWWWWWWWWWWWWWWWWWWWWWWWWWWWWWWWWW....................................................WWWWWWWWWWWWWWWWWWWWWWWWWWWW............EEEE........WWWWQQQQ............BBBB
BBBB........................WWWWQQQQWWWWWWWWWWWWWWWWWWWWWWWWWWWWWWWWWWWW....................................................WWWWWWWWWWWWWWWWWWWWWWWWWWWW............EEEE........WWWWQQQQ............BBBB
BBBB........................WWWWQQQQWWWWWWWWWWWWWWWWWWWWWWWWWWWWWWWWWWWW....................................................WWWWWWWWWWWWWWWWWWWWWWWWWWWW............EEEE........WWWWQQQQ............BBBB
BBBB........................WWWWQQQQWWWWWWWWWWWWWWWWWWWW........................................................................WWWWWWWWWWWWWWWWWWWWWWWW........................WWWWWWWW............BBBB
BBBB........................WWWWQQQQWWWWWWWWWWWWWWWWWWWW........................................................................WWWWWWWWWWWWWWWWWWWWWWWW........................WWWWWWWW............BBBB
BBBB........................WWWWQQQQWWWWWWWWWWWWWWWWWWWW........................................................................WWWWWWWWWWWWWWWWWWWWWWWW........................WWWWWWWW............BBBB
BBBB........................WWWWQQQQWWWWWWWWWWWWWWWWWWWW........................................................................WWWWWWWWWWWWWWWWWWWWWWWW........................WWWWWWWW............BBBB
BBBB........................WWWWQQQQQQQQWWWWWWWW................................................................................WWWWWWWWWWWWWWWW................WWWWWWWWWWWWWWWWWWWWWWWW............BBBB
BBBB........................WWWWQQQQQQQQWWWWWWWW................................................................................WWWWWWWWWWWWWWWW................WWWWWWWWWWWWWWWWWWWWWWWW............BBBB
BBBB........................WWWWQQQQQQQQWWWWWWWW................................................................................WWWWWWWWWWWWWWWW................WWWWWWWWWWWWWWWWWWWWWWWW............BBBB
BBBB........................WWWWQQQQQQQQWWWWWWWW................................................................................WWWWWWWWWWWWWWWW................WWWWWWWWWWWWWWWWWWWWWWWW............BBBB
BBBB........................WWWWWWWWWWWWWWWWWWWWWWWW................................................................................WWWWWWWWWWWWWWWWWWWWWWWWWWWWWWWWWWWWWWWWWWWWWWWWWWWW............BBBB
BBBB........................WWWWWWWWWWWWWWWWWWWWWWWW................................................................................WWWWWWWWWWWWWWWWWWWWWWWWWWWWWWWWWWWWWWWWWWWWWWWWWWWW............BBBB
BBBB........................WWWWWWWWWWWWWWWWWWWWWWWW................................................................................WWWWWWWWWWWWWWWWWWWWWWWWWWWWWWWWWWWWWWWWWWWWWWWWWWWW............BBBB
BBBB........................WWWWWWWWWWWWWWWWWWWWWWWW................................................................................WWWWWWWWWWWWWWWWWWWWWWWWWWWWWWWWWWWWWWWWWWWWWWWWWWWW............BBBB
BBBB........................WWWWWWWWWWWWWWWWWWWWWWWWWWWWWWWWWWWWWWWWWWWWWWWWWWWW............................................WWWWWWWWWWWWWWWWWWWWWWWWWWWWQQQQWWWWWWWWWWWWWWWWWWWWWWWWWWWW............BBBB
BBBB........................WWWWWWWWWWWWWWWWWWWWWWWWWWWWWWWWWWWWWWWWWWWWWWWWWWWW............................................WWWWWWWWWWWWWWWWWWWWWWWWWWWWQQQQWWWWWWWWWWWWWWWWWWWWWWWWWWWW............BBBB
BBBB........................WWWWWWWWWWWWWWWWWWWWWWWWWWWWWWWWWWWWWWWWWWWWWWWWWWWW............................................WWWWWWWWWWWWWWWWWWWWWWWWWWWWQQQQWWWWWWWWWWWWWWWWWWWWWWWWWWWW............BBBB
BBBB........................WWWWWWWWWWWWWWWWWWWWWWWWWWWWWWWWWWWWWWWWWWWWWWWWWWWW............................................WWWWWWWWWWWWWWWWWWWWWWWWWWWWQQQQWWWWWWWWWWWWWWWWWWWWWWWWWWWW............BBBB
BBBB........................WWWWWWWWWWWWWWWWWWWWQQQQQQQQQQQQWWWWWWWWWWWWWWWWWWWWWWWWWWWWWWWWWWWWWWWWWWWWWWWW........WWWWWWWWWWWWWWWWWWWWWWWWWWWWWWWWWWWWWWWWWWWWWWWWQQQQQQQQWWWWWWWWWWWW............BBBB
BBBB........................WWWWWWWWWWWWWWWWWWWWQQQQQQQQQQQQWWWWWWWWWWWWWWWWWWWWWWWWWWWWWWWWWWWWWWWWWWWWWWWW........WWWWWWWWWWWWWWWWWWWWWWWWWWWWWWWWWWWWWWWWWWWWWWWWQQQQQQQQWWWWWWWWWWWW............BBBB
BBBB........................WWWWWWWWWWWWWWWWWWWWQQQQQQQQQQQQWWWWWWWWWWWWWWWWWWWWWWWWWWWWWWWWWWWWWWWWWWWWWWWW........WWWWWWWWWWWWWWWWWWWWWWWWWWWWWWWWWWWWWWWWWWWWWWWWQQQQQQQQWWWWWWWWWWWW............BBBB
BBBB........................WWWWWWWWWWWWWWWWWWWWQQQQQQQQQQQQWWWWWWWWWWWWWWWWWWWWWWWWWWWWWWWWWWWWWWWWWWWWWWWW........WWWWWWWWWWWWWWWWWWWWWWWWWWWWWWWWWWWWWWWWWWWWWWWWQQQQQQQQWWWWWWWWWWWW............BBBB
BBBB........................WWWWWWWWWWWWWWWWWWWWWWWWWWWWWWWWWWWWWWWWWWWWWWWWWWWWWWWWWWWWWWWWWWWWWWWWWWWWWWWWWWWWWWWWWWWWWWWWWWWWWWWWWWWWWWWWWWWWWWWWWWWWWWWWWWWWWWWWWWWWWWWWWWWWWWWWWWWW............BBBB
BBBB........................WWWWWWWWWWWWWWWWWWWWWWWWWWWWWWWWWWWWWWWWWWWWWWWWWWWWWWWWWWWWWWWWWWWWWWWWWWWWWWWWWWWWWWWWWWWWWWWWWWWWWWWWWWWWWWWWWWWWWWWWWWWWWWWWWWWWWWWWWWWWWWWWWWWWWWWWWWWW............BBBB
BBBB........................WWWWWWWWWWWWWWWWWWWWWWWWWWWWWWWWWWWWWWWWWWWWWWWWWWWWWWWWWWWWWWWWWWWWWWWWWWWWWWWWWWWWWWWWWWWWWWWWWWWWWWWWWWWWWWWWWWWWWWWWWWWWWWWWWWWWWWWWWWWWWWWWWWWWWWWWWWWW............BBBB
BBBB........................WWWWWWWWWWWWWWWWWWWWWWWWWWWWWWWWWWWWWWWWWWWWWWWWWWWWWWWWWWWWWWWWWWWWWWWWWWWWWWWWWWWWWWWWWWWWWWWWWWWWWWWWWWWWWWWWWWWWWWWWWWWWWWWWWWWWWWWWWWWWWWWWWWWWWWWWWWWW............BBBB
BBBB........................WWWWWWWWWWWWWWWWWWWWWWWWWWWW............................WWWWWWWWWWWWWWWWWWWWWWWW....WWWWWWWWWWWWWWWWWWWWWWWWWWWW........................WWWWWWWWWWWWWWWWWWWW............BBBB
BBBB........................WWWWWWWWWWWWWWWWWWWWWWWWWWWW............................WWWWWWWWWWWWWWWWWWWWWWWW....WWWWWWWWWWWWWWWWWWWWWWWWWWWW........................WWWWWWWWWWWWWWWWWWWW............BBBB
BBBB........................WWWWWWWWWWWWWWWWWWWWWWWWWWWW............................WWWWWWWWWWWWWWWWWWWWWWWW....WWWWWWWWWWWWWWWWWWWWWWWWWWWW........................WWWWWWWWWWWWWWWWWWWW............BBBB
BBBB........................WWWWWWWWWWWWWWWWWWWWWWWWWWWW............................WWWWWWWWWWWWWWWWWWWWWWWW....WWWWWWWWWWWWWWWWWWWWWWWWWWWW........................WWWWWWWWWWWWWWWWWWWW............BBBB
BBBB........................QQQQQQQQ............................................WWWWWWWWWWWWWWWWWWWWWWWWQQQQ....WWWWWWWWQQQQQQQQQQQQ................................WWWWWWWWWWWWWWWWWWWW............BBBB
BBBB........................QQQQQQQQ............................................WWWWWWWWWWWWWWWWWWWWWWWWQQQQ....WWWWWWWWQQQQQQQQQQQQ................................WWWWWWWWWWWWWWWWWWWW............BBBB
BBBB........................QQQQQQQQ............................................WWWWWWWWWWWWWWWWWWWWWWWWQQQQ....WWWWWWWWQQQQQQQQQQQQ................................WWWWWWWWWWWWWWWWWWWW............BBBB
BBBB........................QQQQQQQQ............................................WWWWWWWWWWWWWWWWWWWWWWWWQQQQ....WWWWWWWWQQQQQQQQQQQQ................................WWWWWWWWWWWWWWWWWWWW............BBBB
BBBB........................QQQQQQQQQQQQQQQQWWWW........................................QQQQQQQQQQQQWWWWQQQQQQQQQQQQQQQQ........................................WWWWWWWWWWWWQQQQWWWWWWWW............BBBB
BBBB........................QQQQQQQQQQQQQQQQWWWW........................................QQQQQQQQQQQQWWWWQQQQQQQQQQQQQQQQ........................................WWWWWWWWWWWWQQQQWWWWWWWW............BBBB
BBBB........................QQQQQQQQQQQQQQQQWWWW........................................QQQQQQQQQQQQWWWWQQQQQQQQQQQQQQQQ........................................WWWWWWWWWWWWQQQQWWWWWWWW............BBBB
BBBB........................QQQQQQQQQQQQQQQQWWWW........................................QQQQQQQQQQQQWWWWQQQQQQQQQQQQQQQQ........................................WWWWWWWWWWWWQQQQWWWWWWWW............BBBB
BBBB........................QQQQWWWWWWWWWWWWWWWWWWWWWWWWWWWWWWWWWWWWWWWWWWWWWWWWWWWWWWWWWWWWQQQQQQQQWWWWWWWWWWWWWWWWWWWW....................WWWWWWWWWWWWWWWWWWWWWWWWWWWWWWWWWWWWWWWWWWWW........PPPPBBBB
BBBB........................QQQQWWWWWWWWWWWWWWWWWWWWWWWWWWWWWWWWWWWWWWWWWWWWWWWWWWWWWWWWWWWWQQQQQQQQWWWWWWWWWWWWWWWWWWWW....................WWWWWWWWWWWWWWWWWWWWWWWWWWWWWWWWWWWWWWWWWWWW........PPPPBBBB
BBBB........................QQQQWWWWWWWWWWWWWWWWWWWWWWWWWWWWWWWWWWWWWWWWWWWWWWWWWWWWWWWWWWWWQQQQQQQQWWWWWWWWWWWWWWWWWWWW....................WWWWWWWWWWWWWWWWWWWWWWWWWWWWWWWWWWWWWWWWWWWW........PPPPBBBB
BBBB........................QQQQWWWWWWWWWWWWWWWWWWWWWWWWWWWWWWWWWWWWWWWWWWWWWWWWWWWWWWWWWWWWQQQQQQQQWWWWWWWWWWWWWWWWWWWW....................WWWWWWWWWWWWWWWWWWWWWWWWWWWWWWWWWWWWWWWWWWWW........PPPPBBBB
BBBBBBBBBBBBBBBBBBBBBBBBBBBBBBBBBBBBBBBBBBBBBBBBBBBBBBBBBBBBBBBBBBBBBBBBBBBBBBBBBBBBBBBBBBBBBBBBBBBBBBBBBBBBBBBBBBBBBBBBBBBBBBBBBBBBBBBBBBBBBBBBBBBBBBBBBBBBBBBBBBBBBBBBBBBBBBBBBBBBBBBBBBBBBBBBBBBBBBBB
BBBBBBBBBBBBBBBBBBBBBBBBBBBBBBBBBBBBBBBBBBBBBBBBBBBBBBBBBBBBBBBBBBBBBBBBBBBBBBBBBBBBBBBBBBBBBBBBBBBBBBBBBBBBBBBBBBBBBBBBBBBBBBBBBBBBBBBBBBBBBBBBBBBBBBBBBBBBBBBBBBBBBBBBBBBBBBBBBBBBBBBBBBBBBBBBBBBBBBBB
BBBBBBBBBBBBBBBBBBBBBBBBBBBBBBBBBBBBBBBBBBBBBBBBBBBBBBBBBBBBBBBBBBBBBBBBBBBBBBBBBBBBBBBBBBBBBBBBBBBBBBBBBBBBBBBBBBBBBBBBBBBBBBBBBBBBBBBBBBBBBBBBBBBBBBBBBBBBBBBBBBBBBBBBBBBBBBBBBBBBBBBBBBBBBBBBBBBBBBBB
BBBBBBBBBBBBBBBBBBBBBBBBBBBBBBBBBBBBBBBBBBBBBBBBBBBBBBBBBBBBBBBBBBBBBBBBBBBBBBBBBBBBBBBBBBBBBBBBBBBBBBBBBBBBBBBBBBBBBBBBBBBBBBBBBBBBBBBBBBBBBBBBBBBBBBBBBBBBBBBBBBBBBBBBBBBBBBBBBBBBBBBBBBBBBBBBBBBBBBBB
