BBBBBBBBBBBBBBBBBBBBBBBBBBBBBBBBBBBBBBBBBBBBBBBBBBBBBBBBBBBBBBBBBBBBBBBBBBBBBBBBBBBBBBBBBBBBBBBBBBBB
BBBBBBBBBBBBBBBBBBBBBBBBBBBBBBBBBBBBBBBBBBBBBBBBBBBBBBBBBBBBBBBBBBBBBBBBBBBBBBBBBBBBBBBBBBBBBBBBBBBB
BBTT..........WWWWWWWWWWWWWWWWWWWWWWWWWWWWWWWWWWWWWWWWWWWWWWWWWWWWWWWWWWWWWW....WWWWWWQQQQQQ......BB
BBTT..........WWWWWWWWWWWWWWWWWWWWWWWWWWWWWWWWWWWWWWWWWWWWWWWWWWWWWWWWWWWWWW....WWWWWWQQQQQQ......BB
BB............WWWWWWWW....WWWWWWWWWWWWWWWWWWWWWWWWWWWWWWWWWWWWWWWWWWWWWWWW........CC....QQQQ......BB
BB............WWWWWWWW....WWWWWWWWWWWWWWWWWWWWWWWWWWWWWWWWWWWWWWWWWWWWWWWW........CC....QQQQ......BB
BB............WWQQWWWWWWWWWWWWWWWWWW..........................WWWWWWWWWWWWWW......EE....WWQQ......BB
BB............WWQQWWWWWWWWWWWWWWWWWW..........................WWWWWWWWWWWWWW......EE....WWQQ......BB
BB............WWQQWWWWWWWWWW....................................WWWWWWWWWWWW............WWWW......BB
BB............WWQQWWWWWWWWWW....................................WWWWWWWWWWWW............WWWW......BB
BB............WWQQQQWWWW........................................WWWWWWWW........WWWWWWWWWWWW......BB
BB............WWQQQQWWWW........................................WWWWWWWW........WWWWWWWWWWWW......BB
BB............WWWWWWWWWWWW........................................WWWWWWWWWWWWWWWWWWWWWWWWWW......BB
BB............WWWWWWWWWWWW........................................WWWWWWWWWWWWWWWWWWWWWWWWWW......BB
BB............WWWWWWWWWWWWWWWWWWWWWWWWWW......................WWWWWWWWWWWWWWQQWWWWWWWWWWWWWW......BB
BB............WWWWWWWWWWWWWWWWWWWWWWWWWW......................WWWWWWWWWWWWWWQQWWWWWWWWWWWWWW......BB
BB............WWWWWWWWWWQQQQQQWWWWWWWWWWWWWWWWWWWWWWWW....WWWWWWWWWWWWWWWWWWWWWWWWQQQQWWWWWW......BB
BB............WWWWWWWWWWQQQQQQWWWWWWWWWWWWWWWWWWWWWWWW....WWWWWWWWWWWWWWWWWWWWWWWWQQQQWWWWWW......BB
BB............WWWWWWWWWWWWWWWWWWWWWWWWWWWWWWWWWWWWWWWWWWWWWWWWWWWWWWWWWWWWWWWWWWWWWWWWWWWWWW......BB
BB............WWWWWWWWWWWWWWWWWWWWWWWWWWWWWWWWWWWWWWWWWWWWWWWWWWWWWWWWWWWWWWWWWWWWWWWWWWWWWW......BB
BB............WWWWWWWWWWWWWW..............WWWWWWWWWWWW..WWWWWWWWWWWWWW............WWWWWWWWWW......BB
BB............WWWWWWWWWWWWWW..............WWWWWWWWWWWW..WWWWWWWWWWWWWW............WWWWWWWWWW......BB
BB............QQQQ......................WWWWWWWWWWWWQQ..WWWWQQQQQQ................WWWWWWWWWW......BB
BB............QQQQ......................WWWWWWWWWWWWQQ..WWWWQQQQQQ................WWWWWWWWWW......BB
BB............QQQQQQQQWW....................QQQQQQWWQQQQQQQQ....................WWWWWWQQWWWW......BB
BB............QQQQQQQQWW....................QQQQQQWWQQQQQQQQ....................WWWWWWQQWWWW......BB
BB............QQWWWWWWWWWWWWWWWWWWWWWWWWWWWWWWQQQQWWWWWWWWWW..........WWWWWWWWWWWWWWWWWWWWWW....PPBB
BB............QQWWWWWWWWWWWWWWWWWWWWWWWWWWWWWWQQQQWWWWWWWWWW..........WWWWWWWWWWWWWWWWWWWWWW....PPBB
BBBBBBBBBBBBBBBBBBBBBBBBBBBBBBBBBBBBBBBBBBBBBBBBBBBBBBBBBBBBBBBBBBBBBBBBBBBBBBBBBBBBBBBBBBBBBBBBBBBB
BBBBBBBBBBBBBBBBBBBBBBBBBBBBBBBBBBBBBBBBBBBBBBBBBBBBBBBBBBBBBBBBBBBBBBBBBBBBBBBBBBBBBBBBBBBBBBBBBBBB
